111111111111111111
1P0000000000000001
1000000000000000C1
100000000000000001
100000000000000001
10000C000000000001
10000C0000000000E1
111111111111111111