11111111111
1P000000001
1C0001000C1
10001C11001
11000C000E1
11111111111