111111
1C0P01
100001
1C11E1
111111