1111111111
10000I0001
110000CC01
1C100C0011
1100000EC1
1111111111