11111
10P01
1C001
1CEC1
11111
