1111111111
1P00100001
10000C0001
10C00000E1
1111111111