1111111111
10000P0001
100000CC01
1C000C0001
10000000E1
1111111111
